#########################
# #         #   #       #
# ## ## # # # # ### # # #
#     # # # T #   # # # #
##### ### ## #### # # # #
#   #   # #         #   #
# # ### # ### ## #### ###
# # #   #   # #   #     #
#   # # ### # # ### ### #
# # # #   #     #     # #
# # # # # # ### ### # # #
# #   # # #   #     # # #
# # ### # ### # # ### # #
#         # # #     # # #
# # # ### # # # ### ### #
# #     # # # #   #   # #
# # ### # # # # # ### # #
# # #   # #       # #   #
# # # ### # ### # # ### #
#   #   #     # # #     #
# ###### #### # # ## ####
# #       #   # #    #  #
# ### ### #S### # ##### #
#     #                 #
#########################
