#####
# S #
## ##
#   #
### #
#T  #
#####
